L=4
N=16
K=5
LEVEL 1
R R B  G B B T1 B T1 T2 G G G B  T1 T2
R R G  G B B T1 R T2 G  G B B G  T1 T2
R R G  R W R T1 G T2 G  G G B G  T1 T2
R R R  G B B T1 B T1 T2 G G G B  T1 T2
R R R  G B B T3 B T1 T2 G G R B  T1 T2
R R G  R G B T2 R T3 T2 G G G B  T1 T2
R R B  G B B T1 B T1 T2 G G G B  T1 T2
R R G  G B B R  B T1 T2 G G G B  T1 T2
R R G  R G G G  R T3 T2 G G R B  T1 T2
R R R  G B B T1 B T1 T2 G G B B  T1 T2
R R T3 G B B R  B T1 B  R R G B  T1 T2
R R G  B R G B  R T3 T2 G B G B  T1 T2
R R G  R B R G  T3 R G  R G B T1 T2 T3
R R T3 G B B T1 B T1 T2 G G R B  T1 T2
R R T3 G B B B  R G  G  R B G B  T1 T2
R R G  R W G B  B T3 T2 G G G B  T1 T2
LEVEL 2
R R E G B B T1 B T1 T2 G G G B  T1 T2
R R E G B B T1 B T1 T2 G G G B  T1 T2
R R E G B B E  B T1 T2 G G E B  T1 T2
R R G E E E E  E T3 T2 G G G B  T1 T2
R R E G B B T1 B T1 T2 G G G B  T1 T2
R R E G B B E  B T1 T2 G G E B  T1 T2
R R G E E E E  E T3 T2 G G G B  T1 T2
R R E G B B T1 B T1 T2 G G G B  T1 T2
R R E G B B T1 B T1 T2 G G G B  T1 T2
R R E G B B E  B T1 T2 G G E B  T1 T2
R R G E E E E  E T3 T2 E G G B  T1 T2
R R E G B B T1 B T1 T2 E G G B  T1 T2
R R E G B B T1 B T1 T2 E G G B  T1 T2
R R E G B B E  B T1 T2 E E E B  T1 T2
R R G E E E E  E T3 T2 G G G B  T1 T2
R R E G B B T1 B T1 T2 G G G B  T1 T2
LEVEL 3
R R E G B B T1 B T1 T2 G G G B  T1 T2
R R E G B B E  B T1 T2 G G E B  T1 T2
R R G E E E E  E T3 T2 G G G B  T1 T2
R R E G B B T1 B T1 T2 G G G B  T1 T2
R R E G B B E  B T1 T2 G G E B  T1 T2
R R G E E E E  E T3 T2 G G G B  T1 T2
R R E G B B T1 B T1 T2 G G G B  T1 T2
R R E G B B E  B E  E  E G E B  T1 T2
R R G E E E E  E T3 T2 G G E B  T1 T2
R R E G B B T1 B T1 T2 G G E B  T1 T2
R R E G B B E  B T1 E  E E E B  T1 T2
R R G E E E E  E T3 T2 G E G B  T1 T2
R R G E E E E  E T3 T2 G E E B  T1 T2
R R E G B B T1 B T1 T2 G G E B  T1 T2
R R E G B B E  E E  E  E E E B  T1 T2
R R G E E E E  E T3 T2 G G G B  T1 T2
LEVEL 4
R R E G B B T1 B T1 T2 G W G B  T1 T2
R R E G B B E  B T1 T2 G G E B  T1 T2
R R G E E E E  E T3 T2 G G G B  T1 T2
R R E G B B T1 B T1 T2 G G G B  T1 T2
R R E G B B E  B T1 T2 G G E B  T1 T2
R R G E E E E  E T3 T2 G G G B  T1 T2
R R E G B B T1 B T1 T2 G G G B  T1 T2
R R E G B B E  B T1 T2 G G E B  T1 T2
R R G E E E E  E T3 T2 G G E B  T1 T2
R R E G B B T1 B T1 T2 G G E B  T1 T2
R R E G B B E  B T1 E  E E E B  T1 T2
R R G E E E E  E T3 T2 G E G B  T1 T2
R R G E E E E  E T3 T2 G E E B  T1 T2
R R E G B B T1 B T1 T2 G G E B  T1 T2
R R E G B B E  E E  E  E E E B  T1 T2
W R G E E E E  E T3 T2 G G G B  T1 T2
END OF MAZE
